8 x 10
~~#~~~##
``#~~~~~
___~#~~~
^__#____
^__^__##
^____###
RRRRR###
________
^^^^^^^_