8 x 8
~~#~~~##
``#~~~~~
___~#~~~
^__#____
^_____##
^____###
^^^^^###
________